**********
*P       *
*     ****
*    M   *
*        *
*        *
****     *
*  M     *
*       G*
**********